Government transparency enables the public to hold the government accountable for how they spend their money.	['DEMOCRACY IS A FACADE']	ABILITY TO EVALUATE GOVERNMENT IS ABILITY TO SEE
Beijing has encouraged regional authorities to introduce sunshine policies that tackle corruption through increased transparency.	[]	ABILITY TO EVALUATE GOVERNMENT IS ABILITY TO SEE
He has a hot temper.	[]	ANGER IS HEAT
He's burning with rage.	['ANGER IS FIRE']	ANGER IS HEAT
Those are inflammatory remarks.	[]	ANGER IS FIRE
He was consumed by his anger.	[]	ANGER IS FIRE
WE CANNOT HAVE ISLANDS OF PROSPERITY NEXT TO OCEANS OF POVERTY AND SQUALOR	['AMOUNT OF POVERTY IS SIZE OF GEOGRAPHIC FEATURE']	AMOUNT OF POVERTY IS SIZE OF GEOGRAPHIC FEATURE
flood of guns	['AMOUNT OF GUNS IS A FLUID', 'GUN VIOLENCE IS A FLUID', 'GUNS ARE A NATURAL DISASTER', 'AMOUNT OF GUN VIOLENCE IS A FLUID']	AMOUNT OF GUNS IS A FLUID
We have not found a way to stem this rising flood of gun violence.	['VIOLENCE IS A FLUID', 'GUN VIOLENCE IS A FLUID', 'AMOUNT OF GUN VIOLENCE IS A FLUID']	AMOUNT OF GUN VIOLENCE IS A FLUID
We are drowning in an ocean of gun violence.	[]	AMOUNT OF GUN VIOLENCE IS A FLUID
He started going down a bad life path.	[]	ALTERNATIVES ARE DIFFERENT AVAILABLE PATHS
That remark is completely impenetrable.	[]	WORDS ARE CONTAINERS
The eye possesses several parts.	[]	WHOLES ARE POSSESSORS
Which car part belongs to which car?	[]	WHOLES ARE POSSESSORS
Despite the debt crisis, the welfare bureaucracy continued to hum along, producing checks every month.	['BUREAUCRATS ARE MACHINE PARTS', 'WELL-FUNCTIONING BUREAUCRACY IS A SMOOTHLY FUNCTIONING MACHINE', 'BUREAUCRACY IS A MACHINE', 'NONFUNCTIONAL BUREAUCRACY IS A BROKEN MACHINE']	WELL-FUNCTIONING BUREAUCRACY IS A SMOOTHLY FUNCTIONING MACHINE
The human cost of that disaster is enormous.	[]	WELL-BEING IS WEALTH
The voters of Dillon have clearly spoken.	[]	VOTING IS SPEAKING
The island is now in full view.	[]	VISUAL FIELD IS A CONTAINER
We are working hard to rebuild the trust of our customers.	[]	TRUST RELATIONSHIPS ARE BUILDINGS
The scandals have shaken the foundations of trust in the market.	['TRUST RELATIONSHIPS ARE BUILDINGS']	TRUST RELATIONSHIPS ARE BUILDINGS
It is how, in every Western country, trust in government has suddenly, dramatically collapsed in the crisis' aftermath.	[]	TRUST IN GOVERNMENT IS A BUILDING
My morning has been very full.	[]	TIME PERIODS ARE CONTAINERS
We spent all day at the fair.	[]	TIME IS MONEY
Time-theft	[]	TIME IS MONEY
The flow of time	['TIME IS A LANDSCAPE THROUGH WHICH THE OBSERVER MOVES', 'MONEY TRANSFER IS FLUID MOTION']	TIME IS A SUBSTANCE
Like sands through the hourglass, so are the days of our lives.	['TIME IS A SUBSTANCE']	TIME IS A SUBSTANCE
Our time is valuable.	[]	TIME IS A RESOURCE
Time flies.	['TIME IS A LANDSCAPE THROUGH WHICH THE OBSERVER MOVES']	TIME IS A MOVING OBJECT
The time will come when…	['TIME IS A LANDSCAPE THROUGH WHICH THE OBSERVER MOVES']	TIME IS A MOVING OBJECT
The time has long since gone when…	[]	TIME IS A MOVING OBJECT
The time for action has arrived.	[]	TIME IS A MOVING OBJECT
You can't go back in time!	['FUTURE IS AHEAD', 'PAST IS BEHIND']	TIME IS A LANDSCAPE THROUGH WHICH THE OBSERVER MOVES
We're looking ahead to the future.	[]	TIME IS A LANDSCAPE THROUGH WHICH THE OBSERVER MOVES
He has a great future in front of him.	['FUTURE IS AHEAD', 'PAST IS BEHIND']	TIME IS A LANDSCAPE THROUGH WHICH THE OBSERVER MOVES
Don't waste your time.	[]	TIME IS A COMMODITY
I can barely hear myself think.	[]	THINKING IS SPEAKING
He's an articulate thinker.	[]	THINKING IS SPEAKING
She doesn't listen to her conscience.	[]	THINKING IS SPEAKING
Let's toss some ideas around.	['THINKING IS MOVING']	THINKING IS OBJECT MANIPULATION
I can't read her mind.	[]	THINKING IS LINGUISTIC ACTIVITY
I misread his intentions.	[]	THINKING IS LINGUISTIC ACTIVITY
Her theory requires the reader to understand  many interconnected factors.	[]	THEORIES ARE COMPLEX STRUCTURES
Opponents tried to dismantle the theory piece by piece.	[]	THEORIES ARE BUILDINGS
This theory has a solid foundation.	[]	THEORIES ARE BUILDINGS
The theoretical framework needs to be filled in with empirical data.	[]	THEORIES ARE BUILDINGS
The dummies were 2-to-1 in favor of the Arizona immigration law; the court gutted it. Only those dummies, not in a state of denial, understand that we the people have lost control of our government.	[]	TERMINATION OF CONTROL IS LOSS OF A POSSESSION
But meanwhile, you may not have noticed that our government gave away control of the Internet.	[]	TERMINATION OF CONTROL IS LOSS OF A POSSESSION
"During a panel discussion that included Washington Governor Christine Gregoire and Nevada Governor Brian Sandoval, Brown accused California lawmakers of adhering to ""the notion that taxes are like some kind of sexually transmitted disease,"" the Los Angeles Times reports."	['TAXES ARE DISEASES']	TAXES ARE DISEASES
Those insidious taxes infect every aspect of our lives.	['TAXES ARE DISEASES']	TAXES ARE DISEASES
Government steals the people's wealth through overt and hidden taxes	['TAXATION IS THEFT']	TAXATION IS THEFT
America Tax Slaves Work 6.5 Months Every Year to Pay for Government	['TAXATION IS SLAVERY', 'GOVERNMENT IS A SERVANT', 'CITIZENS ARE EYES AND EARS', 'GOVERNMENT IS A PERSON']	TAXATION IS SLAVERY
The state cannot pay its bills and poorly educates its young, and its taxation punishes whatever success that its suffocating regulatory regime does not prevent.	[]	TAXATION IS PUNISHMENT
High sales taxes hurt local small businesses.	['TAXES ARE DISEASES', 'TAXATION IS CAUSING HARM']	TAXATION IS CAUSING HARM
We are being taxed to death!	[]	TAXATION IS CAUSING HARM
According to the Tax Foundation, Texas residents on average shoulder the fifth lowest tax burden compared to other residents in the 50 states.	['TAXATION IS A BURDEN']	TAXATION IS A BURDEN
"The Obama campaign is taking a swipe at Mitt Romney's tax plan in a new television ad, saying it will create a ""heavy load"" for the middle class."	[]	TAXATION IS A BURDEN
President Obama decided to target certain and specific products or services he deems unhealthy and levied heavy taxes on them.	['TAXATION IS A BURDEN']	TAXATION IS A BURDEN
Remember when President Obama literally laughed out loud at the idea his health-care plan would impose taxes on the middle class?	[]	TAXATION IS A BURDEN
The new president delivered on his tax cut promises, which, combined with a recession in 2001, caused the tax burden to fall considerably.	['TAXATION IS A BURDEN']	TAXATION IS A BURDEN
New Taxes Burdensome for Farm and Ranch Families	['TAXATION IS A BURDEN']	TAXATION IS A BURDEN
He fell from power.	[]	SUBJUGATION IS DOWN
His power is on the decline.	[]	SUBJUGATION IS DOWN
She fell in status.	['AMOUNT OF POVERTY IS SIZE OF GEOGRAPHIC FEATURE']	STATUS IS VERTICALITY
He's a social climber.	[]	STATUS IS VERTICALITY
I reached a plateau in my career some years back.	[]	STATUS IS VERTICALITY
East Timor took the first steps toward independence in the 1990s.	[]	STATE OF NATION IS LOCATION ALONG PATH
The country is slowly moving out of recession.	[]	STATE OF NATION IS LOCATION ALONG PATH
Our society is suffering from many social problems.	[]	SOCIETY IS A PERSON
Functionalism interprets each part of society in terms of how it contributes to the stability of the whole society. Society is more than the sum of its parts; rather, ...	['SOCIAL GROUP IS A BOUNDED REGION', 'SOCIETY IS A COMPLEX STRUCTURE', 'SOCIAL GROUPS ARE COMPLEX STRUCTURES', 'INSTITUTION IS A COMPLEX PHYSICAL OBJECT', 'COMPANY IS A COMPLEX STRUCTURE']	SOCIETY IS A COMPLEX STRUCTURE
A cure for social ills? Prevention	[]	SOCIAL PROBLEMS ARE PHYSICAL AFFLICTIONS
UW researcher is a leader in showing how prevention techniques can pay off in curing social problems.	[]	SOCIAL PROBLEMS ARE PHYSICAL AFFLICTIONS
Our society is turning gangrene with dishonesty.	[]	SOCIAL PROBLEMS ARE DISEASES
My business is growing like a weed.	[]	SOCIAL ORGANIZATIONS ARE PLANTS
Our circle of friends is quite diverse.	[]	SOCIAL GROUPS ARE CONTAINERS
He's hasn't penetrated that group.	[]	SOCIAL GROUPS ARE CONTAINERS
He's about to rock the foundations of the literary establishment with his novel.	['INSTITUTIONS ARE BUILDINGS', 'GOVERNMENT INSTITUTION IS A BUILDING', 'EFFECTIVE GOVERNMENT INSTITUTION IS A STRONG BUILDING']	SOCIAL GROUPS ARE BUILDINGS
By early afternoon, queues were already building up.	[]	SOCIAL GROUPS ARE BUILDINGS
Cop scandals fray the social fabric.	['SOCIAL GROUP IS A FABRIC']	SOCIAL GROUP IS A FABRIC
Her hair is very near to his in color.	[]	SIMILARITY IS PROXIMITY
That's far from a perfect circle.	[]	SIMILARITY IS PROXIMITY
They adopted the customs of their neighbors.	[]	SELECTION IS ADOPTION
He's looking for meaning in his life and isn't finding any.	[]	SEEKING KNOWLEDGE IS SEARCHING
His eyes scoured the horizon.	[]	SEEING IS TOUCHING
The temperature shot up.	[]	SCALES ARE PATHS
Fuel consumption rose to the highest it has been in 20 years.	[]	SCALES ARE PATHS
My spirits sank.	[]	SAD IS DOWN
Our relationship is veering off-course.	[]	ROMANTIC RELATIONSHIPS ARE VEHICLES
It feels like this relationship is going nowhere.	[]	ROMANTIC RELATIONSHIP IS A JOURNEY
The coup toppled the brutal dictatorship.	[]	REVOLUTION IS TOPPLING A PHYSICAL OBJECT
The Revolutionary and Napoleonic Wars tore down the ancient structure of Europe	[]	REVOLUTION IS TOPPLING A PHYSICAL OBJECT
Their relationship is built on a solid foundation of trust and commitment.	['RELATIONSHIPS ARE PHYSICAL STRUCTURES', 'MARRIAGE IS CLOTH', 'TRUST RELATIONSHIPS ARE BUILDINGS']	RELATIONSHIPS ARE PHYSICAL STRUCTURES
Our relationship is rock solid.	[]	RELATIONSHIPS ARE OBJECTS
She has a fragile relationship with her mother as it is.	[]	RELATIONSHIPS ARE OBJECTS
It takes work to build any relationship.	['RELATIONSHIPS ARE PHYSICAL STRUCTURES', 'MARRIAGE IS CLOTH', 'TRUST RELATIONSHIPS ARE BUILDINGS']	RELATIONSHIPS ARE COMPLEX STRUCTURES
These ideas are closely related.	[]	RELATEDNESS IS PROXIMITY
I concede that it has become indispensable to prune legislation, but it seems to me that this must be done with prudence and thought.	[]	REFINING A LAW IS TRIMMING A PLANT
His income fell last year.	[]	QUANTITY IS VERTICALITY
What is the size of your bank account?	[]	QUANTITY IS SIZE
He doesn't know how big our national debt is.	[]	QUANTITY IS SIZE
We are trying to find the most elegant approach to solving this problem.	[]	PURPOSEFUL THINKING IS GOAL-DIRECTED MOTION
She made great strides in her dissertation.	[]	PURPOSEFUL ACTION IS SELF-PROPELLED MOTION TO A DESTINATION
Her soul was scrubbed clean of impurities.	[]	PURITY IS CLEANLINESS
You must cleanse your soul of sin.	[]	PURIFYING IS CLEANSING
The impure must be washed clean through contrition.	[]	PURIFYING IS CLEANSING
The accusation wounded her.	[]	PSYCHOLOGICAL HARM IS PHYSICAL INJURY
My pride was wounded.	[]	PSYCHOLOGICAL HARM IS PHYSICAL INJURY
She recovered from the wound to her psyche, but scars remained.	[]	PSYCHOLOGICAL HARM IS PHYSICAL INJURY
Life is full of peaks and valleys.	[]	PROGRESSING THROUGH LIFE IS MOVING THROUGH A TERRAIN
He hadn't made much headway in writing the termpaper.	[]	PROGRESS IS FORWARD MOTION ALONG A PATH
House Republicans blocked the Democrats' attempts to move forward with the healthcare bill.	[]	PREVENTING ENACTMENT OF LEGISLATION IS BLOCKING MOTION
The Senator's filibuster halted the passage of the bill.	[]	PREVENTING ENACTMENT OF LEGISLATION IS BLOCKING MOTION
They're just half-baked ideas.	[]	PREPARING IDEAS TO BE UNDERSTOOD IS FOOD PREPARATION
Just give me the raw facts.	[]	PREPARING IDEAS TO BE UNDERSTOOD IS FOOD PREPARATION
He holds all the power.	['GUN CONTROL IS PHYSICAL RESTRAINT']	POWER IS A POSSESSED OBJECT
We are not free from the creeping vines of poverty.	['POVERTY IS A PLANT', 'POVERTY IS A WEED']	POVERTY IS A WEED
Mother Martha is working to loosen the strangling weeds of poverty and watching children blossom and thrive under her care.	['POVERTY IS A WEED']	POVERTY IS A WEED
Though politically the country is free, its people remain chained by poverty.	[]	POVERTY IS A MOTION IMPEDIMENT
The epidemic of poverty is spreading in America, and it's taking its toll on American families.	[]	POVERTY IS A DISEASE
As President Obama has said, we can't treat the symptoms of poverty in isolation.	['POVERTY IS A DISEASE']	POVERTY IS A DISEASE
He appealed to logos (logic) by trying to analyze why poverty is a crime and tries to differentiate it from being poor.	['POVERTY IS A CRIME']	POVERTY IS A CRIME
The wildfire of revolution rapidly spread throughout the land.	[]	POLITICAL UNREST IS A WILDFIRE
They are rocking the ship of state.	['NATION IS A VEHICLE', 'POLITICAL REGION IS A VEHICLE', 'NATION IS A BOAT']	POLITICAL REGION IS A VEHICLE
Dirt threatens to sink ship of state	['NATION IS A VEHICLE', 'POLITICAL REGION IS A VEHICLE', 'NATION IS A BOAT']	POLITICAL REGION IS A VEHICLE
His strength declined as he aged.	[]	PHYSICAL STRENGTH IS VERTICALITY
As Election Day drew near, the candidates pulled into the final lap of the race.	['ELECTION IS A BOXING MATCH', 'WINNING AN ELECTION IS WINNING A BOXING MATCH', 'LOSING AN ELECTION IS LOSING A BOXING MATCH', 'PHASE OF AN ELECTION IS LEG IN A RACE', 'LOSING AN ELECTION IS LOSING A RACE', 'WINNING AN ELECTION IS WINNING A RACE', 'ELECTION IS A RACE']	PHASE OF AN ELECTION IS LEG IN A RACE
Last Legs of Campaign Can Decide Race	[]	PHASE OF AN ELECTION IS LEG IN A RACE
How both candidates fair in the final leg of campaigning will likely determine the winner in each state.	[]	PHASE OF AN ELECTION IS LEG IN A RACE
The young man is rather green and does not have enough experience to drive the large machinery.	['PEOPLE ARE PLANTS']	PEOPLE ARE PLANTS
We saw the withered old woman.	[]	PEOPLE ARE PLANTS
Incurable sex offenders, lousy judges and the new media: Moral panic sustenance in the age of new media	[]	Ongoing causation is nourishing
The Lakers' defense fell apart in the final quarter leading to an embarrassing upset.	[]	ORGANIZATION IS PHYSICAL STRUCTURE
Opportunity is an open door.	['IMPEDIMENTS TO UTILIZING EDUCATIONAL OPPORTUNITIES IS OBSTACLES TO ACCESSING A LOCATION', 'OPPORTUNITIES ARE PORTALS', 'PREVENTING UTILIZATION OF EDUCATIONAL RESOURCES IS CLOSING A PORTAL']	OPPORTUNITIES ARE PORTALS
His job offer opened up new paths of opportunity for him.	['OPPORTUNITIES ARE PATHS']	OPPORTUNITIES ARE PATHS
I've squandered every opportunity to advance my career.	[]	OPPORTUNITIES ARE OBJECTS
Canada is by far the closest of all our neighbors.	[]	NEARBY COUNTRIES ARE NEIGHBORS
3rd #WinterWeatherAdvisory in 3 weeks. Think #MotherNature doesn't want an early spring :P	[]	NATURE IS AN AGENT
Dear #Mothernature , please don't tease us Texans with this awesome weather until you plan on staying this way. Thanks:)	[]	NATURE IS AN AGENT
Nature Tries to Shift Outer Banks, But Man Keeps Shoveling It Back	[]	NATURE IS AN AGENT
... we must deepen our understanding of the economic value of nature and invest in the vital services that it provides for us, if we are to have a truly sustainable economic future.	[]	NATURE IS A RESOURCE
To start with, everything we are made of and everything we make comes from the environment.	[]	NATURE IS A RESOURCE
International Poll Finds U.S. Still Viewed As World's Bully	[]	NATIONS WHO ABUSE POWER ARE BULLIES
Great Powers and Outlaw States: Unequal Sovereigns in the International Legal Order	[]	NATIONS NOT ABIDING BY INTERNATIONAL LAW ARE OUTLAWS
Obama accused the Republicans of moving the goalposts in the debate about the deficit.	[]	NATIONAL POLITICS IS A SPORTS FIELD
Women: We Want You on the Political Battlefield	[]	NATIONAL POLITICS IS A BATTLEFIELD
But Scott Brown’s win in the Massachusetts Senate race does raise a bigger question: is the system broken? I fear the answer is yes.	[]	NATIONAL POLITICAL FUNCTIONALITY IS PHYSICAL INTEGRITY
The infrastructure that is the foundation of our nation is eroding, endangering the whole structure of our economy.	['NATION IS A BUILDING']	NATIONAL INFRASTRUCTURE DETERIORATION IS BUILDING EROSION
Our nation contains some of the best entrepreneurs in the world.	[]	NATION IS CONTAINER
Only one thing stands between Western civilization and chaos: the United States.	[]	NATION IS AN OBJECT
Saltykov explored the psychological problems resulting from the shifting of a nation's gears, of creating a new way of life.	['NATION IS A VEHICLE', 'POLITICAL REGION IS A VEHICLE', 'NATION IS A MACHINE']	NATION IS A VEHICLE
We must rouse our nation from its slumber.	[]	NATION IS A PERSON
If the President doesn't show some leadership, the country will grind to a halt.	['NATION IS A VEHICLE', 'POLITICAL REGION IS A VEHICLE']	NATION IS A MACHINE
...and asked them to be serious towards bringing a full-fledged budget at the earliest to ensure that the country functions smoothly.	[]	NATION IS A MACHINE
Our national arguments are family arguments, we still talk to each other at the end of the day.	['NATION IS A FAMILY']	NATION IS A FAMILY
"""Are They Parts of Our Nation? Tanzanian and Zambian University Students’ Attitude to the European and South Asian Minorities Compared"""	['NATION IS AN OBJECT', 'SOCIETY IS A COMPLEX STRUCTURE', 'NATION IS A COMPLEX STRUCTURE', 'STATE OF NATION IS LOCATION ALONG PATH']	NATION IS A COMPLEX STRUCTURE
No one built this country on their own. This nation is great because we built it together.	['NATION IS A BUILDING', 'NATION IS A MACHINE']	NATION IS A COMPLEX STRUCTURE
“This is a time to build a nation, brick by brick, pillar by pillar, not a time to tear down our brothers and sisters or pillage their property,”	['NATION IS A BUILDING', 'NATION IS A MACHINE']	NATION IS A BUILDING
They represent the brick and mortar of our nation's developing infrastructure.	['NATION IS A BUILDING']	NATION IS A BUILDING
"""Our nation is built on the bedrock principle that governments derive their just powers from the consent of the governed."""	['NATION IS A BUILDING', 'NATION IS A MACHINE']	NATION IS A BUILDING
Within a federalist framework the nation is a body in crisis threatened from within by one of its own. It is about to be dismembered.	['NATION IS AN OBJECT', 'NATION IS A BODY', 'NATION IS A PERSON', 'NATION IS A FAMILY', 'SOCIETY IS A PERSON', 'SOCIAL FUNCTIONING IS PHYSICAL HEALTH', 'NATION IS A SYSTEM']	NATION IS A BODY
Iowa is the heart of the nation, where everyone greets you with a smile and you wave at strangers!	['NATION IS A BODY']	NATION IS A BODY
Scuttling the Ship of State to appease climate activists	['NATION IS A VEHICLE', 'POLITICAL REGION IS A VEHICLE', 'NATION IS A BOAT']	NATION IS A BOAT
Our country is burdened by debt and that may sink us in the rough waters ahead.	[]	NATION IS A BOAT
The grazing field was covered with sheep.	[]	MULTIPLICITY IS MASS
The city is expanding the number of recycling containers in parks.	[]	MORE IS BIG
God-fearing men must keep strictly to the straight and narrow.	[]	MORAL IS STRAIGHT
The government takes good care of its people.	[]	MORAL AGENTS ARE NURTURING PARENTS
He's morally bankrupt.	[]	MORAL ACTION IS A FINANCIAL TRANSACTION
cash flow	['MONEY TRANSFER IS FLUID MOTION']	MONEY TRANSFER IS FLUID MOTION
The money is gushing out of my retirement account.	[]	MONEY TRANSFER IS FLUID MOTION
The money is all dried up.	[]	MONEY IS A LIQUID
Liquid assets.	['RESOURCE IS A LIQUID']	MONEY IS A LIQUID
We're still trying to grind out the solution to this equation.	[]	MIND IS A MACHINE
My mind isn't operating today.	[]	MIND IS A MACHINE
It's all in your mind.	[]	MIND IS A CONTAINER
Keep it in the back of your mind.	['WORSENING MOOD IS DOWNWARD MOTION']	MIND IS A CONTAINER
She came to a calculated decision.	[]	MIND IS A COMPUTER
Let me make a mental note of that.	[]	MEMORIZATION IS WRITING
It's imprinted in my mind forever.	[]	MEMORIZATION IS WRITING
It is unclear how the new law applies to this situation.	[]	MAKING RELATED IS CAUSING CONTACT
Before we draw any conclusions, we must weigh both sides of the issue.	[]	MAKING A DECISION IS WEIGHING
The engine is dying; we need to repair it.	[]	MACHINES ARE PEOPLE
It was a hard-fought battle, but in the end Romney didn't have the numbers to overpower Obama.	[]	LOSING AN ELECTION IS LOSING A WAR
While at first the numbers were on his side, eventually Gore had to admit defeat to Bush in 2000.	[]	LOSING AN ELECTION IS LOSING A WAR
While Perry appeared to be the frontrunner, Romney came out ahead in the GOP primary.	[]	LOSING AN ELECTION IS LOSING A RACE
In the presidential race of 2008, John McCain came up short.	[]	LOSING AN ELECTION IS LOSING A RACE
During the Democratic primary in 2008, John Edwards came out swinging but was swiftly knocked out of the election.	[]	LOSING AN ELECTION IS LOSING A BOXING MATCH
It's time to take the next big step in my life.	[]	LIFE IS A SEQUENCE OF MOTIONS
She hasn't gone as far in life as her parents had hoped.	[]	LIFE IS A JOURNEY
His life has taken a good course.	[]	LIFE IS A JOURNEY
As I've traveled through life, I've made a lot of friends along the way.	[]	LIFE IS A JOURNEY
He has changed his direction in life, and taken a more spiritual path.	[]	LIFE IS A JOURNEY
She has very little money.	[]	LESS IS SMALL
The number of available parking spaces continues to shrink.	[]	LESS IS SMALL
Congress is producing little this election year that will become law, yet both parties are churning out bills designed to make the other side look bad.	[]	LEGISLATIVE ACTIVITY IS MAKING OBJECTS
This gives me a great idea!	[]	LEARNING IS ACQUIRING
I got a much better idea of what was going on after the last meeting.	['IDEAS ARE POSSESSIONS']	LEARNING IS ACQUIRING
She had acquired an intimate knowledge of the terrain, which now helped her to travel quickly.	[]	LEARNING IS ACQUIRING
Her experience gave her a great deal of knowledge.	[]	LEARNING IS ACQUIRING
The president is steering the country into unknown waters.	[]	LEADING A NATION IS STEERING A BOAT
The president drove the nation into a ditch.	[]	LEADING A NATION IS DRIVING A VEHICLE
Obama on GOP: 'They Drove The Country Into A Ditch...Now They Want The Keys Back'	[]	LEADING A NATION IS DRIVING A VEHICLE
Where was he when he drove our country off a cliff?	[]	LEADING A NATION IS DRIVING A VEHICLE
Obama is the head of the country, whether some people don't like democracy or not.	['NATION IS AN OBJECT', 'NATION IS A BODY', 'NATION IS A COMPLEX STRUCTURE']	LEADER OF A NATION IS HEAD OF BODY
Out of these discussions will grow legislation of farreaching importance.	[]	LAWS ARE PLANTS
dismantle gun laws	[]	LAWS ARE PHYSICAL STRUCTURES
How to Build A Law	['MARRIAGE IS CLOTH']	LAWS ARE OBJECTS
Aug 25, 2010 – And so, two of the main pillars of our democracy—a free press and the courts—will be assailed at the same time.	[]	LAW ENFORCEMENT IS SUPPORTING A STRUCTURE
I've almost got an idea, but I can't quite put my finger on it.	[]	KNOWING IS TOUCHING
I could never put my finger on what the problem was. I felt crazy at times and there were so many times that I would approach him with a very well-thought out ...	[]	KNOWING IS TOUCHING
I see what you mean.	[]	KNOWING IS SEEING
I see what you mean.	[]	KNOWING IS PERCEIVING
Feb 24, 2007 – A judge is often thought of in terms of a referree. But can a judge really be as objective as a sporting umpire?	[]	JUDGES ARE SPORTS REFEREES
Emigration has threatened to unravel the fabric of this small society.	['SOCIAL GROUP IS A FABRIC']	INTERRELATEDNESS IS PHYSICAL INTERCONNECTEDNESS
The chairman has managed to weave together quite a coalition	[]	INTERRELATEDNESS IS PHYSICAL INTERCONNECTEDNESS
Which country is your country's best friend?	[]	INTERNATIONAL RELATIONS ARE INTERPERSONAL RELATIONSHIPS
He has an appetite for learning.	[]	INTEREST IN IDEAS IS APPETITE FOR FOOD
He has an insatiable curiosity.	[]	INTEREST IN IDEAS IS APPETITE FOR FOOD
Trading has really heated up this week.	[]	INTENSITY OF ACTIVITY IS HEAT
The Crumbling Walls of the Roman Catholic Church	[]	INSTITUTIONS ARE BUILDINGS
May 27, 2011 – The “health” of an institution is measured by the effectiveness of its organization and mission, and also by how well it plans for the future.	[]	INSTITUTION IS AN ORGANISM
I would venture to conclude from this that institutions are vehicles of subcultures driven by groups of people with a common destination	['INSTITUTION IS A VEHICLE', 'GOVERNMENT INSTITUTION IS A MACHINE', 'ORGANIZATION IS A MACHINE', 'EFFECTIVE GOVERNMENT INSTITUTION IS A WELL-FUNCTIONING MACHINE', 'INSTITUTION IS A MACHINE']	INSTITUTION IS A VEHICLE
More especially, the analogy mentioned between institutions and machines must not be interpreted as proposing the theory that institutions are machines—in some essentialist sense.	['INSTITUTION IS A VEHICLE', 'GOVERNMENT INSTITUTION IS A MACHINE', 'ORGANIZATION IS A MACHINE', 'EFFECTIVE GOVERNMENT INSTITUTION IS A WELL-FUNCTIONING MACHINE', 'INSTITUTION IS A MACHINE']	INSTITUTION IS A MACHINE
Society’s great institutions are factories of ideas, regularly churning out new frameworks, insights, and understanding.	['INSTITUTIONS ARE BUILDINGS', 'GOVERNMENT INSTITUTION IS A BUILDING', 'EFFECTIVE GOVERNMENT INSTITUTION IS A STRONG BUILDING', 'INSTITUTION IS A FACTORY']	INSTITUTION IS A FACTORY
In this view, educational instititions are factories that take less productive workers as their raw materials, apply doses of training, and create more productive workers as outputs.	['INSTITUTIONS ARE BUILDINGS', 'GOVERNMENT INSTITUTION IS A BUILDING', 'EFFECTIVE GOVERNMENT INSTITUTION IS A STRONG BUILDING', 'INSTITUTION IS A FACTORY']	INSTITUTION IS A FACTORY
Religious institutions are businesses, the sermons are infomercials, the verse are nothing but commercial slogans.	['EFFECTIVE GOVERNMENT IS A WELL-MANAGED BUSINESS', 'GOVERNMENT IS A BUSINESS', 'INEFFECTIVE GOVERNMENT IS A POORLY-MANAGED BUSINESS', 'INSTITUTION IS A BUSINESS']	INSTITUTION IS A BUSINESS
Institutions Are Businesses, Too	['EFFECTIVE GOVERNMENT IS A WELL-MANAGED BUSINESS', 'GOVERNMENT IS A BUSINESS', 'INEFFECTIVE GOVERNMENT IS A POORLY-MANAGED BUSINESS', 'INSTITUTION IS A BUSINESS']	INSTITUTION IS A BUSINESS
Senate Republicans blocked legislation Wednesday that would have established a  billion jobs program putting veterans back to work tending to the country's federal lands and bolstering local police and fire departments.	[]	INHIBITTING ENACTMENT OF LEGISLATION IS IMPEDING MOTION
This mini-controversy erupted when Republicans introduced a string of amendments in a final effort to obstruct passage of the reconciliation bill.	[]	INHIBITTING ENACTMENT OF LEGISLATION IS IMPEDING MOTION
The detective couldn't get much information out of the partial shoe print.	[]	INFORMATION IS CONTENTS
Tree rings contain the story of the region.	[]	INFORMATION IS CONTENTS
It was years before the fossils yielded any valuable information.	[]	INFORMATION IS CONTENTS
Germany Leads the World	[]	INFLUENTIAL NATIONS ARE LEADERS
China leads successful wildlife crime crackdown	[]	INFLUENTIAL NATIONS ARE LEADERS
Moving up the social ladder: The bottom rung vs the top rung	[]	INEQUALITY IS BEING ON DIFFERENT VERTICAL LEVELS
Tom Barrett: Put state government on a diet	[]	INEFFICIENT GOVERNMENT IS A BLOATED BODY
The business of municipal government is, in general, the most poorly managed business in the world.	['CITIZENS ARE EMPLOYERS', 'EFFECTIVE GOVERNMENT IS A WELL-MANAGED BUSINESS', 'INSTITUTION IS A BUSINESS', 'GOVERNMENT IS A BUSINESS', 'NATION IS A BUSINESS', 'INEFFECTIVE GOVERNMENT IS A POORLY-MANAGED BUSINESS']	INEFFECTIVE GOVERNMENT IS A POORLY-MANAGED BUSINESS
Debt, debt, debt; we're drowning in it. This morning, the Office for National Statistics published the latest estimates of public sector borrowing. Though borrowing is falling faster than anticipated, thanks to the fact that spending cuts are finally beginning to kick in, the national debt has risen to 64.2 per cent of GDP. More significantly, we now owe more than £1 trillion, or around £16,000 for every person in the country.	[]	INCREASING GOVERNMENT DEBT IS RISING WATER LEVEL
Increasing transparency in government (title of article, International Journal on World Peace)	['DEMOCRACY IS A FACADE']	INCREASING EVALUABILITY OF GOVERNMENT IS INCREASING TRANSPARENCY
As It Opens to Outsiders, Cuba Is Infected by Crime	['INCREASE IN CRIME IS SPREAD OF DISEASE', 'CRIME IS A DISEASE']	INCREASE IN CRIME IS SPREAD OF DISEASE
The issue is central to these negotiations.	[]	IMPORTANT IS CENTRAL
That's a lightweight issue.	[]	IMPORTANCE IS WEIGHT
This is a substantive / substantial problem for us.	['AMOUNT OF PROBLEM IS SIZE']	IMPORTANCE IS WEIGHT
Texaco is a relatively small player in the California gasoline market but a bigger factor in the Eastern states that want to follow California's lead.	[]	IMPORTANCE IS SIZE
The consequence of idolatry is the moral disintegration of human society.	['CORRUPTION IS DECAY']	IMMORALITY IS DEGENERATION
He's a crooked politician.	[]	IMMORAL IS CROOKED
Shatter the rules of the market economy	[]	ILLEGAL ACTIVITY IS BREAKING A PHYSICAL OBJECT
I have an idea.	['IDEAS ARE POSSESSIONS', 'ACQUIRING IDEAS IS EATING']	IDEAS ARE POSSESSIONS
She gave me a good idea.	[]	IDEAS ARE POSSESSIONS
The theory of relativity gave birth to an enormous number of ideas in physics.	[]	IDEAS ARE PEOPLE
He is the father of modern biology.	[]	IDEAS ARE PEOPLE
Look at what his ideas have spawned.	[]	IDEAS ARE PEOPLE
Those ideas died off in the Middle Ages.	[]	IDEAS ARE PEOPLE
His ideas will live on forever.	[]	IDEAS ARE PEOPLE
Cognitive psychology is still in its infancy.	[]	IDEAS ARE PEOPLE
That's an idea that ought to be resurrected.	[]	IDEAS ARE PEOPLE
He breathed new life into that idea.	[]	IDEAS ARE PEOPLE
This is what happens when science serves up facts more indigestible than evolution. We end up with a society where the masses live in outright ignorance and denial, while the dominant institutions, thanks to market and political expediency, continually reorganize themselves around actionable intelligence as it comes in.	[]	IDEAS ARE FOOD
Food for thought nust be appetizing. Chemistry students usually can write acceptable exposition if they know good writing is expected	['INTERESTING IDEAS ARE APPETIZING FOODS', 'ACQUIRING IDEAS IS EATING', 'IDEAS ARE FOOD', 'COGNIZING IS EATING', 'LEARNING IS GETTING NUTRITIOUS FOOD', 'INTEREST IN IDEAS IS APPETITE FOR FOOD']	IDEAS ARE FOOD
He'll rise to the top.	[]	HIGH STATUS IS UP
He's at the peak of his career.	[]	HIGH STATUS IS UP
He's climbing the ladder of success.	[]	HIGH STATUS IS UP
They are at the bottom of the social hierarchy.	[]	HIGH STATUS IS UP
She fell in status.	['AMOUNT OF POVERTY IS SIZE OF GEOGRAPHIC FEATURE']	HIGH STATUS IS UP
He's gone over my head to the top supervisor.	[]	HIERARCHY IS A VERTICAL STRUCTURE
He's down with the flu.	['DISEASES ARE BURDENS', 'SURVIVING CANCER IS HARMING CANCER']	HEALTH IS VERTICALITY
He's at the peak of health.	['HEALTH IS UP']	HEALTH IS UP
He's in top shape.	[]	HEALTH IS UP
That boosted my spirits.	[]	HAPPY IS UP
My spirits rose.	[]	HAPPY IS UP
You're in high spirits.	[]	HAPPY IS UP
I'm soaring with joy.	[]	HAPPINESS IS VERTICALITY
His spirits fell.	[]	HAPPINESS IS VERTICALITY
gun-infested state	[]	GUNS ARE PESTS
altar of gun ownership	[]	GUNS ARE OBJECTS OF WORSHIP
worship guns	[]	GUNS ARE OBJECTS OF WORSHIP
glorify firearms	[]	GUNS ARE OBJECTS OF WORSHIP
The primary reason Americans are addicted to guns is due to the National Rifle Association's very effective — and immoral — campaign to instill fear into the heart of our citizens, which has paralyzed the soul of America.	[]	GUNS ARE DRUGS
avalanche of guns	['GUNS ARE A NATURAL DISASTER']	GUNS ARE A NATURAL DISASTER
‘America’s gun disease is a national security issue’	['GUN CONTROL REGULATION IS A DISEASE', 'GUNS ARE A DISEASE']	GUNS ARE A DISEASE
cancerous gun violence	[]	GUN VIOLENCE IS A PHYSICAL AFFLICTION
plague of gun violence	[]	GUN VIOLENCE IS A PHYSICAL AFFLICTION
Cynicism has killed the gun-control debate	[]	GUN DEBATE IS A LIVING ENTITY
saddle the American people with gun control	['GOVERNMENT REGULATION IS A BURDEN']	GUN CONTROL REGULATION IS A MOTION IMPEDIMENT
gun control trap	['GUN CONTROL IS PHYSICAL RESTRAINT']	GUN CONTROL REGULATION IS A MOTION IMPEDIMENT
gun control sickness	['GUN CONTROL REGULATION IS A DISEASE', 'REGULATION IS A DISEASE']	GUN CONTROL REGULATION IS A DISEASE
oppressive shackles of gun control	['GUN CONTROL IS PHYSICAL RESTRAINT']	GUN CONTROL IS PHYSICAL RESTRAINT
the gun lobby has squashed federal funding	[]	GUN CONTROL ADVOCACY IS PHYSICAL HARM
She guided him through the problem.	[]	GUIDED ACTION IS GUIDED MOTION ALONG A PATH
She walked him through the analysis.	[]	GUIDED ACTION IS GUIDED MOTION ALONG A PATH
She led him through the rough parts of the course.	[]	GUIDED ACTION IS GUIDED MOTION ALONG A PATH
The Milky Way belongs to a cluster of galaxies.	[]	GROUPS ARE POSSESSORS
Our galaxy has at least 100 billion planets.	[]	GROUPS ARE POSSESSORS
"Earth is part of the group of ""terrestrial"" planets."	['SOCIAL GROUP IS A BOUNDED REGION', 'IDEA SYSTEMS ARE FLUID MASSES', 'GROUPS ARE PART-WHOLE STRUCTURES', 'CATEGORIES ARE BOUNDED REGIONS', 'SOCIAL GROUPS ARE COMPLEX STRUCTURES', 'IDEA SYSTEMS ARE COMPLEX PHYSICAL SYSTEMS', 'INSTITUTION IS A COMPLEX PHYSICAL OBJECT', 'COMPANY IS A COMPLEX STRUCTURE']	GROUPS ARE PART-WHOLE STRUCTURES
This group contains twenty members.	[]	GROUPS ARE CONTAINERS
There are twenty members in this group.	['CATEGORIES ARE BOUNDED REGIONS', 'SOCIAL GROUP IS A BOUNDED REGION', 'GOVERNMENT IS A SERVANT']	GROUPS ARE CONTAINERS
He salivated with the thought of earning more money.	[]	GREED IS HUNGER
The robber baron hungered for even greater profits.	[]	GREED IS HUNGER
House Democrats and Republicans moved closer to agreeing on a budget today.	[]	GOVERNMENTAL AGREEMENT IS PHYSICAL PROXIMITY
The government must shore up support for our religious freedoms.	[]	GOVERNMENT'S POSITIVE TREATMENT OF RIGHTS IS SUPPORTING A PHYSICAL STRUCTURE
We need to strengthen our civil liberties.	[]	GOVERNMENT'S POSITIVE TREATMENT OF RIGHTS IS STRENGTHENING AN OBJECT
These gay marriage laws have invaded our religious rights.	[]	GOVERNMENT'S HARMFUL TREATMENT OF RIGHTS IS TRESPASSING
The government needs to stay out of my bedroom.	[]	GOVERNMENT'S HARMFUL TREATMENT OF RIGHTS IS TRESPASSING
The government's move to censor the internet is trampling all over our rights to free speech and freedom of the press.	[]	GOVERNMENT'S HARMFUL TREATMENT OF RIGHTS IS TRAMPLING ON AN OBJECT
Overturning Roe v. Wade would steal away our right to privacy.	[]	GOVERNMENT'S HARMFUL TREATMENT OF RIGHTS IS THEFT
The government overstepped a line when they proposed wiretapping citizens' phone lines.	[]	GOVERNMENT'S HARMFUL TREATMENT OF RIGHTS IS INVADING A TERRITORY
Gay marriage is encroaching on our religious freedoms.	[]	GOVERNMENT'S HARMFUL TREATMENT OF RIGHTS IS INVADING A TERRITORY
Every new bill the President proposes chips away at our freedoms.	[]	GOVERNMENT'S HARMFUL TREATMENT OF RIGHTS IS DAMAGING A PHYSICAL STRUCTURE
Imposing martial law will undermine the very foundations of democracy.	[]	GOVERNMENT'S HARMFUL TREATMENT OF RIGHTS IS DAMAGING A PHYSICAL STRUCTURE
Gun control is an assault on our civil liberties.	[]	GOVERNMENT'S HARMFUL TREATMENT OF RIGHTS IS ATTACKING
The entrepreneur was suffocated by the all the onerous regulations he had to follow.	[]	GOVERNMENT REGULATION IS SUFFOCATION
Small business in the United States is literally being suffocated by red tape.	[]	GOVERNMENT REGULATION IS SUFFOCATION
The restrictive regulations are holding back innovation.	[]	GOVERNMENT REGULATION IS A PHYSICAL CONSTRAINT
Any greater government regulation will only handcuff the industry and reduce the significant benefits hedge funds offer to the markets.	['GUN CONTROL IS PHYSICAL RESTRAINT']	GOVERNMENT REGULATION IS A PHYSICAL CONSTRAINT
The burdens of regulation on corporations hold down their profit margins.	['GOVERNMENT REGULATION IS A BURDEN']	GOVERNMENT REGULATION IS A BURDEN
All these rules and regulations are obstacles to innovation.	['GUN CONTROL REGULATION IS A MOTION IMPEDIMENT', 'GOVERNMENT REGULATION IS A BARRIER']	GOVERNMENT REGULATION IS A BARRIER
China Using Government Muscle to Turbo Charge its Auto Industry	['EFFECTIVE GOVERNMENT INSTITUTION IS A HEALTHY BODY', 'NATION IS A BODY', 'GOVERNMENT INSTITUTION IS A BODY', 'EFFICIENT GOVERNMENT IS A LEAN BODY']	GOVERNMENT POWER IS BODILY STRENGTH
India government regains its muscle with reforms	['EFFECTIVE GOVERNMENT INSTITUTION IS A HEALTHY BODY', 'NATION IS A BODY', 'GOVERNMENT INSTITUTION IS A BODY', 'EFFICIENT GOVERNMENT IS A LEAN BODY']	GOVERNMENT POWER IS BODILY STRENGTH
Government should be a referee, not an active player	[]	GOVERNMENT IS REFEREE
Withered government: leave it to the rich	[]	GOVERNMENT IS AN ORGANISM
"“Government is not a machine, but a living thing. It falls, not under the theory of the universe, but under the theory of organic life. It is accountable to Darwin, not to Newton. It is modified by its environment, necessitated by its tasks, shaped to its functions by the sheer pressure of life. No living thing can have its organs offset against each other, as checks, and live."""	[]	GOVERNMENT IS AN ORGANISM
There can be no doubt that the federal government is the new slave master, something the Founding Fathers warned us against.	[]	GOVERNMENT IS A SLAVE MASTER
Citizen Sheep Government Shepherds	['GOVERNMENT IS A SHEPHERD', 'GOVERNMENT IS A LEADER']	GOVERNMENT IS A SHEPHERD
Such a power does not destroy, but it prevents existence; it does not tyrannize, but it compresses, enervates, extinguishes, and stupefies a people, till each nation is reduced to nothing better than a flock of timid and industrious animals, of which the government is the shepherd.	['GOVERNMENT IS A SHEPHERD', 'GOVERNMENT IS A LEADER']	GOVERNMENT IS A SHEPHERD
Obama and the Progressives do not believe this. They believe they must decide what is best. In their view Americans are sheep and they are the shepherd.	[]	GOVERNMENT IS A SHEPHERD
The government should cater to the needs of its citizens.	[]	GOVERNMENT IS A SERVANT
A proper government is only a policeman, acting as an agent of man’s self-defense, and, as such, may resort to force only against those who start the use of force.	['GOVERNMENT IS A SHEPHERD']	GOVERNMENT IS A POLICEMAN
The US government loves you. In fact, it loves you so much that it’s willing shackle your legs together. Just to protect you – tough love, baby. Now, it may hurt a bit but just try to breathe through the pain. Remember – it hurts the government more than it hurts you.	['COMPANY IS A FAMILY', 'GOVERNMENT IS A PARENT', 'NATION IS AN OBJECT', 'INSTITUTION IS A COMPLEX PHYSICAL OBJECT', 'NATION IS A FAMILY', 'COMPANY IS A COMPLEX STRUCTURE', 'NATION IS A COMPLEX STRUCTURE']	GOVERNMENT IS A PERSON
The government is infected with corruption.	['TAXES ARE DISEASES']	GOVERNMENT IS A PATIENT
We must cure our ailing democracy with an infusion of new politicians.	[]	GOVERNMENT IS A PATIENT
Big Father: The Government as Parent	['GOVERNMENT IS A PARENT', 'COMPANY IS A FAMILY', 'NATION IS A FAMILY']	GOVERNMENT IS A PARENT
"Doctrine of Parens Patriae."" Parens Patriae means literally, ""parent of the country."" It refers traditionally to the role of STATE as sovereign and guardian of persons under legal disability."	['GOVERNMENT IS A PARENT', 'NATION IS A FAMILY']	GOVERNMENT IS A PARENT
"""In my view, the federal government should lead the way.  The bill we’ve introduced requires the federal government to increase its use of renewable electricity and reduce its overall energy consumption in federal buildings, both new and old.  We can’t expect consumers to embrace energy efficient technology if their government does not do the same."""	['GOVERNMENT IS A LEADER']	GOVERNMENT IS A LEADER
Parents are so uneducated about health that they will follow the government down any misguided path.	['GOVERNMENT IS A LEADER']	GOVERNMENT IS A LEADER
The Syrian government is driving Syria into a dangerous zone.	['INSTITUTION IS A VEHICLE', 'NATION IS A VEHICLE']	GOVERNMENT IS A DRIVER
The current Japanese government is steering the country toward Socialism.	['LEADING A NATION IS STEERING A BOAT', 'GOVERNMENT IS A DRIVER', 'LEADING A NATION IS DRIVING A VEHICLE']	GOVERNMENT IS A DRIVER
to promote his fantasy that big government can cure our nation's ills.	[]	GOVERNMENT IS A DOCTOR
Once the stage has been set, radical surgery will be required to actually remove the malignant tumor that Cancerous Government has become.	[]	GOVERNMENT IS A DISEASE
I believe in personal responsibility and the government shouldn't be a babysitter but I also believe in compassion for less advantageous people.	[]	GOVERNMENT IS A CHILDCARE PROVIDER
Can I decide what size soda I want to drink? No, that’s the nanny state’s job.	[]	GOVERNMENT IS A CHILDCARE PROVIDER
One of the worst-run businesses in the United States is also the largest business in the nation. The federal government is in financial disarray. It spends more than it makes and its investments are not based on sound financial principles.	[]	GOVERNMENT IS A BUSINESS
Rising food prices can topple governments	['LEGISLATIVE ACTIVITY IS MOTION ALONG A PATH', 'GOVERNING ACTION IS MOTION']	GOVERNMENT INSTITUTION IS A PHYSICAL STRUCTURE
Afghanistan's government could collapse after 2014.	['INCREASE IN TAXATION IS OCCURENCE OF SUDDEN DESTRUCTIVE NATURAL FORCE']	GOVERNMENT INSTITUTION IS A PHYSICAL STRUCTURE
If the injustice is part of the necessary friction of the machine of government, let it go, let it go: perchance it will wear smooth--certainly the machine will wear out. If the injustice has a spring, or a pulley, or a rope, or a crank, exclusively for itself, then perhaps you may consider whether the remedy will not be worse than the evil; but if it is of such a nature that it requires you to be the agent of injustice to another, then I say, break the law. Let your life be a counter-friction to stop the machine. What I have to do is to see, at any rate, that I do not lend myself to the wrong which I condemn.	['INSTITUTION IS A VEHICLE', 'BUREAUCRACY IS A MACHINE', 'NATION IS A MACHINE', 'GOVERNMENT INSTITUTION IS A MACHINE', 'BUREAUCRATS ARE MACHINE PARTS', 'NONFUNCTIONAL BUREAUCRACY IS A BROKEN MACHINE', 'WELL-FUNCTIONING BUREAUCRACY IS A SMOOTHLY FUNCTIONING MACHINE', 'NATION IS A VEHICLE', 'LEGISLATURE IS A MACHINE', 'EFFECTIVE GOVERNMENT INSTITUTION IS A WELL-FUNCTIONING MACHINE', 'ORGANIZATION IS A MACHINE', 'INSTITUTION IS A MACHINE', 'NONFUNCTIONAL LEGISLATURE IS A BROKEN MACHINE']	GOVERNMENT INSTITUTION IS A MACHINE
They had elected him (Jackson) to conduct the Government and to keep and remove its moneys, and he meant to do so on the principle that it was a simple machine.	['LEADING A NATION IS STEERING A BOAT', 'LEADING A NATION IS DRIVING A VEHICLE', 'GOVERNMENT IS A DRIVER', 'GOVERNMENT IS A LEADER']	GOVERNMENT INSTITUTION IS A MACHINE
This responsibility falls squarely on the shoulders of the government.	['TAXATION IS A BURDEN']	GOVERNMENT INSTITUTION IS A BODY
The government was toppled.	[]	GOVERNMENT FUNCTIONALITY IS VERTICALITY
The government fell.	[]	GOVERNMENT FUNCTIONALITY IS VERTICALITY
The western world is drowning in an ocean of debt unlike anything the world has ever seen before	[]	GOVERNMENT DEBT IS OCEAN
In times of need, the impoverished should be able to lean on our government for support.	[]	GOVERNMENT ASSISTANCE IS SUPPORT
We need welfare as a safety net.	[]	GOVERNMENT ASSISTANCE IS SUPPORT
Our country's poor are addicted to welfare.	[]	GOVERNMENT ASSISTANCE IS AN ADDICTIVE DRUG
We have a nation of welfare addicts who will always depend on the government for their next fix.	[]	GOVERNMENT ASSISTANCE IS AN ADDICTIVE DRUG
...trapping so many people in state dependency robs them of their human dignity.	[]	GOVERNMENT ASSISTANCE IS A TRAP
[T]he federal government's welfare assistance programs intended to help those in need instead effectively trap people into dependence	[]	GOVERNMENT ASSISTANCE IS A TRAP
The government shouldn't just give handouts, it needs to encourage people to get jobs instead.	[]	GOVERNMENT ASSISTANCE IS A HANDOUT
Congress moved quickly to avoid a governmental shutdown.	[]	GOVERNING ACTION IS MOTION
The state took a big step toward banning assault weapons.	[]	GOVERNING ACTION IS MOTION
The legislature is considering an alternative approach to deficit reduction.	[]	GOVERNING ACTION IS MOTION
Postal Service bill faces roadblocks	[]	GOVERNING ACTION IS MOTION
Our President will chart a path to prosperity.	[]	FUTURE OF A NATION IS PATH OF BOAT
We will navigate the choppy waters of recession into smooth fiscal sailing.	[]	FUTURE OF A NATION IS PATH OF BOAT
'Pakistan's economy has ability to navigate through choppy waters'	[]	FUTURE OF A NATION IS PATH OF BOAT
With a heavy Republican majority, Congress churned out bill after bill.	[]	FUNCTIONAL LEGISLATURE IS A FUNCTIONING MACHINE
With a unified House and Senate, the well-oiled gears of government turn smoothly.	[]	FUNCTIONAL LEGISLATURE IS A FUNCTIONING MACHINE
"""I look forward to helping keep the legislative wheels turning smoothly in our 105-day session"""	[]	FUNCTIONAL LEGISLATURE IS A FUNCTIONING MACHINE
Cloture would make the legislative gears turn smoothly.	[]	FUNCTIONAL LEGISLATURE IS A FUNCTIONING MACHINE
The theory is spelled out in chapter 4.	[]	FULLY COMMUNICATING A SEQUENCE OF THOUGHT IS SPELLING
Follow the letter of the law.	[]	FULLY COMMUNICATING A SEQUENCE OF THOUGHT IS SPELLING
This is a well-crafted sentence.	[]	FORMING WORDS IS SHAPING
Promises should be articulated clearly.	[]	FORMING WORDS IS SHAPING
A large force is needed to move a heavy object.	[]	FORCES ARE OBJECTS
She gave him a push.	[]	FORCE TRANSFER IS OBJECT TRANSFER
He gave me a vicious kick.	[]	FORCE TRANSFER IS OBJECT TRANSFER
Again, if by any chance, we should ultimately win out in such a war, what would it cost us in treasure and in blood?	['MONEY IS A LIQUID']	FINANCIAL RESOURCES ARE PHYSICAL RESOURCES
Should Welfare parasites be allowed to bleed working Americans for the rest of their lives without attempting to help themselves?	['ENTITLEMENT HOLDERS ARE LEECHES']	EXPLOITATION OF RESOURCES IS A PARASITIC INFECTION
I have a headache.	[]	EXPERIENCING A STATE IS POSSESSING AN OBJECT
I'm in love.	[]	EXPERIENCING A STATE IS BEING AT A LOCATION
She's out of her depression.	[]	EXPERIENCING A STATE IS BEING AT A LOCATION
She's close to insanity.	[]	EXPERIENCING A STATE IS BEING AT A LOCATION
When at rest, the computer goes into hibernation.	[]	EXPERIENCING A STATE IS BEING AT A LOCATION
He's at an advanced stage in his studies.	[]	EXPERIENCING A STATE IS BEING AT A LOCATION
What state is the project in?	['IMPEDIMENTS TO IMPROVING ECONOMIC STATUS IS WATER CONFINEMENT', 'TAXATION IS INVESTMENT', 'GOVERNMENT IS A SERVANT', 'STATE OF NATION IS LOCATION ALONG PATH', 'RELATIONSHIP IS A BOUNDED REGION IN SPACE', 'IMPEDIMENTS TO IMPROVING ECONOMIC STATUS IS PHYSICAL IMPEDIMENTS TO MOTION', 'TAXATION IS IMPEDIMENTS TO MOTION', 'TAXATION IS PUNISHMENT']	EXPERIENCING A STATE IS BEING AT A LOCATION
I can feel a headache approaching	[]	EXPERIENCED STATE IS A PROXIMATE OBJECT
My symptoms went away.	[]	EXPERIENCED STATE IS A PROXIMATE OBJECT
The Bible clearly teaches that our struggle to live righteously is a struggle against the dark forces of Satan that seeks to rule us.	[]	EVIL IS DARK
The oil spill has caused a shock to the environment.	[]	ENVIRONMENTAL HARM IS PHYSICAL INJURY
Smog pollution is an environmental malaise.	[]	ENVIRONMENTAL HARM IS PHYSICAL INJURY
Ecologists are nursing the Bay back to health.	[]	ENVIRONMENTAL HARM IS PHYSICAL INJURY
"The ""takers"" in this society are leeches on the success of job creators."	[]	ENTITLEMENT HOLDERS ARE LEECHES
We are reaching the end of the house-buying process.	[]	END OF AN ACTION IS THE END OF A PATH
Finally, all my educational goals are in reach.	[]	END OF AN ACTION IS THE END OF A PATH
We are entering the last stages of filing for bankruptcy.	[]	END OF AN ACTION IS THE END OF A PATH
Democrats Push Through Historic, Controversial Health Care Legislation	[]	ENACTING LEGISLATION IS CAUSING MOTION ALONG A PATH
The Senate voted 92-5 Tuesday to move the bill forward to a full vote later this week.	['ENACTING LEGISLATION IS CAUSING MOTION ALONG A PATH', 'MONEY TRANSFER IS FLUID MOTION', 'ALTERNATIVE LEGISLATION IS ALTERNATIVE PATH', 'LEGISLATIVE ACTIVITY IS MOTION ALONG A PATH', 'AMOUNT OF PROGRESS TOWARD ENACTING LEGISLATION IS DISTANCE MOVED ALONG A PATH']	ENACTING LEGISLATION IS CAUSING MOTION ALONG A PATH
He's filled with jealousy.	[]	EMOTIONS ARE SUBSTANCES
She's overflowing with love.	[]	EMOTIONS ARE SUBSTANCES
You have to set your jealousy aside.	[]	EMOTIONS ARE OBJECTS
He hid his love from her.	[]	EMOTIONS ARE OBJECTS
He is a man of fiery passions.	[]	EMOTIONALLY INTENSE IS HOT
Their relationship cooled off and they soon parted ways.	[]	EMOTIONAL INTENSITY IS TEMPERATURE
His mother was always cold and unloving when he was a child.	[]	EMOTIONAL INTENSITY IS TEMPERATURE
He's bursting with excitement.	[]	EMOTION IS PRESSURE IN A CONTAINER
That joke is side-splittingly funny.	[]	EMOTION IS PRESSURE IN A CONTAINER
...the fight for the White House is being waged on intensely local terrain...	[]	ELECTION IS WAR
the war for the presidency is nearly over	[]	ELECTION IS WAR
Both sides girded for battle, as they knew the general election would be a hard-won fight.	['WINNING AN ELECTION IS WINNING A WAR', 'LOSING AN ELECTION IS LOSING A WAR', 'ELECTION IS WAR']	ELECTION IS WAR
Campaign Craft: The Strategies, Tactics, and Art of Political Campaign Management	[]	ELECTION IS WAR
The GOP presidential race has a new front-runner: Gov. Rick Perry.	[]	ELECTION IS A RACE
This year's US presidential election is shaping up to be a very close race, with the incumbent currently in front, but his challenger close on his heels.	['ELECTION IS A BOXING MATCH', 'WINNING AN ELECTION IS WINNING A BOXING MATCH', 'LOSING AN ELECTION IS LOSING A BOXING MATCH', 'PHASE OF AN ELECTION IS LEG IN A RACE', 'LOSING AN ELECTION IS LOSING A RACE', 'WINNING AN ELECTION IS WINNING A RACE', 'ELECTION IS A RACE']	ELECTION IS A RACE
Noem sprints to election finish line with stop in Elk Point, SD.	[]	ELECTION IS A RACE
With the official start of primary season, candidates were off and running as they sought to quickly raise millions of dollars for ad buys.	[]	ELECTION IS A RACE
The Iowa caucuses in January 2012 serve as the starting line of the marathon primary-election campaigns necessary ...	[]	ELECTION IS A RACE
Hutchinson the front-runner in 2014 governor's race	[]	ELECTION IS A RACE
Too often it is post mortem head scratching, as if democratic strategists do not realize every candidate is a pawn on the national. chessboard	[]	ELECTION IS A GAME
Beasley won the first round of Democratic primary for lieutenant governor in 1970, but failed to win a majority.	[]	ELECTION IS A BOXING MATCH
Randy has a plan to turn a bloated government of Washington bureaucrats into a lean and efficient government	[]	EFFICIENT GOVERNMENT IS A LEAN BODY
Our state government, a well oiled machine of efficiency.	[]	EFFECTIVE GOVERNMENT INSTITUTION IS A WELL-FUNCTIONING MACHINE
Like some it is supposed to serve, Massachusetts government has become flabby.	[]	EFFECTIVE GOVERNMENT INSTITUTION IS A HEALTHY BODY
Apparently, I’m not the only parent who’s concerned about high stakes testing.	[]	EDUCATIONAL EVALUATION IS GAMBLING
A good education is a powerful resource.	['EDUCATION IS A RESOURCE']	EDUCATION IS A RESOURCE
With The Economy Humming, Will Manufacturing Software Help Manufacturers Stay In Tune?	[]	ECONOMY IS A MACHINE
"""Although we have a long way to go before we can put this recession behind us, the gears of our economic engine do appear ... to be slowly turning once again,"""	['ECONOMY IS A MACHINE']	ECONOMY IS A MACHINE
The economy is falling apart.	[]	ECONOMY IS A COMPLEX STRUCTURE
force-feed the economy back to health	[]	ECONOMY IS A BODY
The very thought of it makes me sick.	[]	DISTURBING IDEAS ARE DISGUSTING FOODS
The doctors at the CDC led the way to victory against the flu epidemic.	[]	DISEASE TREATMENT IS WAR
The cancer patient fought a long, hard, battle, but she eventually succumbed to her disease.	['CANCER PATIENT IS PHYSICAL COMBATANT']	DISEASE TREATMENT IS WAR
A Triumph in the War Against Cancer	['CANCER TREATMENT IS WAR', 'CANCER IS PHYSICAL COMBAT', 'CANCER PATIENT IS PHYSICAL COMBATANT']	DISEASE TREATMENT IS WAR
With nothing left in their leukemia-fighting arsenal, the doctors were down to Dilaudid, a derivative of morphine...	[]	DISEASE TREATMENT IS WAR
The Weapons of Diplomacy, and the Human Factor	['DIPLOMACY IS WAR']	DIPLOMACY IS WAR
This situation is hard to bear.	[]	DIFFICULTY IS HEAVINESS
This is a very hard problem to solve.	['SOCIAL PROBLEMS ARE PHYSICAL AFFLICTIONS']	DIFFICULTY IS HARDNESS
My life is going nowhere - I'm just spinning my wheels.	[]	DIFFICULTIES IN PROGRESSING THROUGH LIFE ARE IMPEDIMENTS TO MOTION ALONG A PATH
We have a lot of hurdles to get over in our relationship.	[]	DIFFICULTIES IN A ROMANTIC RELATIONSHIP ARE IMPEDIMENTS TO MOTION ALONG A PATH
They faced some tough problems at the beginning of their marriage but got over them quickly.	[]	DIFFICULTIES ARE IMPEDIMENTS TO MOVEMENT
She solved the problem a different way.	[]	DIFFERENT MEANS OF ACHIEVING A PURPOSE ARE DIFFERENT PATHS TO A DESTINATION
Tips on how to cultivate openness to change.	[]	DEVELOPING AN ATTRIBUTE IS CULTIVATION
democracy for sale	[]	DEMOCRATIC IDEOLOGY IS A COMMODITY
plant the seeds of democracy	[]	DEMOCRACY IS A PLANT
democracy blossoms	[]	DEMOCRACY IS A PLANT
fledgling democracy	[]	DEMOCRACY IS A BIRD
democracy spreads its wings	[]	DEMOCRACY IS A BIRD
He is a person of very high moral standards.	[]	DEGREE OF MORALITY IS PHYSICAL HEIGHT
Debt is holding me back from reaching my goals.	[]	DEBT IS PHYSICAL IMPEDIMENTS TO MOTION
Credit card debt has been growing significantly	[]	DEBT IS AN ORGANISM
Obama and Romney Strike Blows Over Benghazi	[]	DEBATING IS ONE-ON-ONE PHYSICAL FIGHTING
He attacked the speaker with harsh words of criticism.	[]	CRITICIZING IS ATTACKING
Crime is a beast ravaging the city.	['ADDRESSING CRIME IS CONTROLLING AN ANIMAL', 'CRIME IS AN ANIMAL', 'UNCONTROLLED CRIME IS A RAMPAGING ANIMAL']	CRIME IS AN ANIMAL
Crime has infected communities everywhere.	['INCREASE IN CRIME IS SPREAD OF DISEASE', 'CRIME IS A DISEASE']	CRIME IS A DISEASE
Out of these discussions will grow legislation of farreaching importance.	[]	CREATING A LAW IS GROWING A PLANT
Corruption is eroding the public trust in government.	['CORRUPTION IS EROSION']	CORRUPTION IS EROSION
Our nation has been infested with the termites of corruption, the worms of immorality, and a virus of indifference and apathy.	[]	CORRUPTION IS A TERMITE INFESTATION
Our government is afflicted with the cancer of corruption.	['CORRUPTION EFFECT IS DISEASE EFFECT', 'CORRUPTION IS A DISEASE']	CORRUPTION IS A DISEASE
Corrupt officials are infecting our government at every level.	[]	CORRUPTION IS A DISEASE
California Cities Struggling Under Wave of Corruption	[]	CORRUPTION IS A DESTRUCTIVE NATURAL PROCESS
FIFA facing corruption 'tsunami'	[]	CORRUPTION IS A DESTRUCTIVE NATURAL PROCESS
Relax. We've got everything under control.	[]	CONTROL IS VERTICALITY
He's in the high command.	[]	CONTROL IS UP
He's in the upper echelon.	[]	CONTROL IS UP
His power rose.	[]	CONTROL IS UP
The president kept his hold on power.	['GUN CONTROL IS PHYSICAL RESTRAINT']	CONTROL IS A POSSESSION
She regained control of the assembly.	[]	CONTROL IS A POSSESSION
His actions are beyond my control.	[]	CONTROL IS A BOUNDED REGION
The whole situation spiraled out of (our) control.	['ACHIEVING POWER IS MOVING UPWARDS', 'CONTROL IS A BOUNDED REGION']	CONTROL IS A BOUNDED REGION
He returned to power.	[]	CONTROL IS A BOUNDED REGION
The president is in control of the executive branch.	['CONTROL IS A BOUNDED REGION']	CONTROL IS A BOUNDED REGION
Developing nations are gobbling up our fossil fuels at any alarming rate.	[]	CONSUMING TOO MANY RESOURCES IS EATING TOO MUCH FOOD
The United States' insatiable appetite for electronics will entirely consume our supply of rare metals.	[]	CONSUMING TOO MANY RESOURCES IS EATING TOO MUCH FOOD
This SUV sure is a gas guzzler.	[]	CONSUMING RESOURCES IS EATING
Demand for paper goods is eating away at our planet's forests.	[]	CONSUMING RESOURCES IS EATING
“Your dead kids don’t trump my Constitutional rights.”	[]	CONSIDERING THE IMPORTANCE OF RIGHTS IS PLAYING A GAME
Wake up!	[]	CONSCIOUS IS UP
Vanity finally drove me to have the operation.	[]	COMPULSION IS A COMPELLING FORCE
We’ve been playing chess for years, and he’s finally pulling ahead of me.	[]	COMPETITION IS A RACE
He’s a better writer than I am, and he’s widening the distance.	[]	COMPETITION IS A RACE
We have to restructure this firm.	[]	COMPANY IS A COMPLEX STRUCTURE
You gave me a great idea!	[]	COMMUNICATING IS OBJECT TRANSFER
Try to pack more thoughts into fewer words.	[]	COMMUNICATING IS OBJECT TRANSFER
Whenever you have a good idea practice capturing it in words.	[]	COMMUNICATING IS OBJECT TRANSFER
Try to get your thoughts across better.	[]	COMMUNICATING IS OBJECT TRANSFER
You still have to give me an idea of what you mean.	[]	COMMUNICATING IS OBJECT TRANSFER
My mind was racing.	[]	COGNIZING IS BODILY FUNCTIONING
My mind is tired.	[]	COGNIZING IS BODILY FUNCTIONING
This new slavery is a total dependence by individuals and families on government for the materials and funds necessary to maintain a minimum standard of living.	[]	CITIZENS ARE SLAVES
...the people of America’s needs and priorities become second to the needs of the state and the people of America become enslaved to the state.	[]	CITIZENS ARE SLAVES
Snitch Culture: How Citizens are Turned into the Eyes and Ears of the State	[]	CITIZENS ARE EYES AND EARS
We need to protect our rights from infringement.	['CITIZEN RIGHTS ARE SHIELDS FROM HARM', 'RIGHTS ARE SHIELDS FROM HARM']	CITIZEN RIGHTS ARE TERRITORIES
Do gun rights protect against tyranny?	['CITIZEN RIGHTS ARE SHIELDS FROM HARM', 'RIGHTS ARE SHIELDS FROM HARM']	CITIZEN RIGHTS ARE SHIELDS FROM HARM
Don't let anyone take away your right to vote.	[]	CITIZEN RIGHTS ARE POSSESSIONS
One down of the three pillars of “unalienable” rights that hold up this great country of ours.	[]	CITIZEN RIGHTS ARE PHYSICAL STRUCTURES
This is an usagainst-them battle, but the “them” are those who would dismantle our rights.	[]	CITIZEN RIGHTS ARE PHYSICAL STRUCTURES
Things have gone from bad to worse lately.	[]	CHANGE OF STATE IS CHANGE OF LOCATION
The US handed over control of the prisoners to Afghan authorities.	[]	CHANGE IN CONTROLLER IS TRANSFER OF POSSESSION
The Democrats wrested control of four governerships from the Republicans	[]	CHANGE IN CONTROLLER IS TRANSFER OF POSSESSION
The government acquired control of the company's assets.	[]	CHANGE IN CONTROLLER IS TRANSFER OF POSSESSION
... allow courts to circumvent the First Amendment, slowly eroding the freedom of the press in a much more subtle manner than if they gagged the media directly.	[]	CENSORSHIP IS PHYSICAL RESTRAINING OF MOUTH
The government should not muzzle the press.	[]	CENSORSHIP IS PHYSICAL RESTRAINING OF MOUTH
Another round of cuts will cripple the economy.	[]	CAUSING ECONOMIC HARDSHIP IS CAUSING PHYSICAL HARM
Thriving community centers have proven to be an effective treatment against violent crime in a number of neighborhoods.	['CAUSING DECREASE IN CRIME IS TREATING DISEASE']	CAUSING DECREASE IN CRIME IS TREATING DISEASE
Tomatoes technically fall within the fruit category.	['CATEGORIES ARE BOUNDED REGIONS']	CATEGORIES ARE BOUNDED REGIONS
I wouldn't put him in the friend category, exactly.	[]	CATEGORIES ARE BOUNDED REGIONS
How to make a career out of things you would do even for free.	[]	CAREER IS A COMPLEX STRUCTURE
Stars whose careers collapsed in a relatively short amount of time	[]	CAREER IS A BUILDING
Here are some tips to grow your business.	[]	BUSINESSES ARE LIVING ENTITIES
You could call me just a work-for-hire hack, and a willing, contented cog in a bureaucratic machine.	['BUREAUCRATS ARE MACHINE PARTS', 'WELL-FUNCTIONING BUREAUCRACY IS A SMOOTHLY FUNCTIONING MACHINE', 'BUREAUCRACY IS A MACHINE', 'NONFUNCTIONAL BUREAUCRACY IS A BROKEN MACHINE']	BUREAUCRATS ARE MACHINE PARTS
Confronted with the grinding cogs of bureaucracy, but needing a new cap, Coltrane shrugged and filled out the form.	['BUREAUCRATS ARE MACHINE PARTS', 'WELL-FUNCTIONING BUREAUCRACY IS A SMOOTHLY FUNCTIONING MACHINE', 'BUREAUCRACY IS A MACHINE', 'NONFUNCTIONAL BUREAUCRACY IS A BROKEN MACHINE']	BUREAUCRACY IS A MACHINE
The creation of this board of unelected bureaucrats is yet another tentacle of the Obama Administration digging its way into the doctors-patient relationship.	['BUREACRACY IS AN OCTOPUS']	BUREACRACY IS AN OCTOPUS
Lost in the bureaucratic maze of city's criminal justice system	['BUREACRACY IS A MAZE']	BUREACRACY IS A MAZE
He was filled with anger.	[]	BODY IS A CONTAINER FOR EMOTIONS
She couldn't contain her joy.	[]	BODY IS A CONTAINER FOR EMOTIONS
She was brimming with rage.	[]	BODY IS A CONTAINER FOR EMOTIONS
Hold on to your beliefs and never let them go.	[]	BELIEFS ARE POSSESSIONS
I refuse to stoop to that kind of behavior.	[]	BEING IMMORAL IS BEING LOW
In a democratic government, authority is given to it by the people.	[]	ATTRIBUTES OF GOVERNMENT ARE ENTITIES
She has a sunny disposition.	[]	ATTRIBUTES ARE POSSESSIONS
This place has lost a lot of its charm.	[]	ATTRIBUTES ARE POSSESSIONS
The new mustache gave him an older appearance.	[]	ATTRIBUTES ARE POSSESSIONS
You could talk about the dealerships, auto dealerships that were closed down when the government got control of a couple of the auto companies, an awful lot of people lost jobs, businesses were closed, and so on.	['CONTROL IS A POSSESSION', 'POWER IS A POSSESSED OBJECT']	ATTAINING CONTROL IS GAINING A POSSESSION
The Shadow Party: How George Soros, Hillary Clinton, and Sixties Radicals Seized Control of the Democratic Party	[]	ATTAINING CONTROL IS GAINING A POSSESSION
I've really been leaning on my friends the past few months.	[]	ASSISTANCE IS SUPPORT
Five is made up of two plus three.	[]	ARITHMETIC IS OBJECT CONSTRUCTION
If you put 2 and 2 together, you get 4.	[]	ARITHMETIC IS OBJECT CONSTRUCTION
He bombarded them with clever arguments.	[]	ARGUMENT IS WAR
His criticisms were right on target.	[]	ARGUMENT IS WAR
Your claims are indefensible.	[]	ARGUMENT IS PHYSICAL COMBAT
He attacked every weak point in my argument.	[]	ARGUMENT IS PHYSICAL COMBAT
His criticisms were right on target.	[]	ARGUMENT IS PHYSICAL COMBAT
I blew his argument out of the water.	[]	ARGUMENT IS PHYSICAL COMBAT
I've never won an argument with him.	[]	ARGUMENT IS PHYSICAL COMBAT
You disagree? OK, shoot!	[]	ARGUMENT IS PHYSICAL COMBAT
He shot down all of my arguments.	[]	ARGUMENT IS PHYSICAL COMBAT
He was just about to burst with anger.	[]	ANGER IS PRESSURE IN A CONTAINER
There seems to be growing friendship between Shia Iran and its Sunni-dominated neighbours.	[]	ALLIANCES ARE FRIENDSHIPS
Of course, gun control fanatics pay little attention to facts.	['ADVOCATING GUN CONTROL IS ZEALOTRY']	ADVOCATING GUN CONTROL IS ZEALOTRY
The most powerful weapon in the war against obesity might be something we all understand: cold, hard cash.	[]	ADDRESSING SOCIAL PROBLEMS IS WAGING WAR
How America's losing the war on poverty	[]	ADDRESSING SOCIAL PROBLEMS IS WAGING WAR
Debt Ceiling Deal: Wrong Diagnosis Leads to Wrong Treatment for What Ails the Economy	[]	ADDRESSING SOCIAL PROBLEMS IS TREATING AN ILLNESS
Improving access to education is the only sure way to cure us of poverty.	[]	ADDRESSING POVERTY IS TREATING AN ILLNESS
Law enforcement officers have often described these arrests as a way of reining in criminals whose other, more serious activities present a danger to the public.	[]	ADDRESSING CRIME IS CONTROLLING AN ANIMAL
In the course of the investigation, new evidence was found.	[]	ACTIVITIES ARE JOURNEYS
Follow along as I assemble this.	[]	ACTIVITIES ARE JOURNEYS
Follow these steps in assembly.	[]	ACTIVITIES ARE JOURNEYS
How did Jerry get out of washing the windows?	[]	ACTIVITIES ARE BOUNDED REGIONS IN SPACE
Outside of washing the windows, what else did you do?	[]	ACTIVITIES ARE BOUNDED REGIONS IN SPACE
I put a lot of energy into washing the windows.	[]	ACTIVITIES ARE BOUNDED REGIONS IN SPACE
I get a lot of satisfaction out of washing windows.	[]	ACTIVITIES ARE BOUNDED REGIONS IN SPACE
She squeezed her way to thinner thighs.	[]	ACTION IS SELF-PROPELLED MOTION ALONG A PATH
She went back to sleep.	[]	ACTION IS SELF-PROPELLED MOTION ALONG A PATH
She successfully navigated her way through the contract negotiations.	[]	ACTION IS SELF-PROPELLED MOTION ALONG A PATH
Congress' refusal to compromise is moving the country toward economic ruin.	[]	ACTION IS MOTION ALONG A PATH
The car is in motion.	[]	ACTION IS BEING IN A LOCATION
I'm going to leave.	[]	ACTION IS BEING IN A LOCATION
She's close to resigning.	[]	ACTION IS BEING IN A LOCATION
We pitched them the idea and they ate it right up.	[]	ACQUIRING IDEAS IS EATING
He's been feeding her lies all these years.	[]	ACQUIRING IDEAS IS EATING
This article is hard to digest.	[]	ACQUIRING IDEAS IS EATING
Hitler's rise to power cannot be attributed to one event, but a mixture of factors including events happening outside Germany...	['LEGISLATIVE ACTIVITY IS MOTION ALONG A PATH', 'GOVERNING ACTION IS MOTION', 'ACHIEVING POWER IS MOVING UPWARDS']	ACHIEVING POWER IS MOVING UPWARDS
Regensburg’s political influence reached its peak when Regensburg was city of the Perpetual Diet or General Assembly of the Imperial Estates of the Holy Roman Empire from 1663 to 1806.	[]	ACHIEVING POWER IS MOVING UPWARDS
The goal is a long way off.	[]	ACHIEVING A PURPOSE IS REACHING A DESTINATION
They just handed him the job.	[]	ACHIEVING A PURPOSE IS ACQUIRING A DESIRED OBJECT
Seize the opportunity.	[]	ACHIEVING A PURPOSE IS ACQUIRING A DESIRED OBJECT
I kept getting close to a world championship, but it kept escaping me.	[]	ACHIEVING A PURPOSE IS ACQUIRING A DESIRED OBJECT
He finally managed to get a smile out of her.	[]	ACHIEVING A PURPOSE IS ACQUIRING A DESIRED OBJECT
She landed four huge accounts this year.	[]	ACHIEVING A PURPOSE IS ACQUIRING A DESIRED OBJECT
Will House Republicans Get Bullied into a Tax Hike By Obama?	[]	ABUSIVE POLITICAL LEADERS ARE PHYSICAL BULLIES
On the other hand, it's making him look indecisive, and as Pat said, he's being pushed around by the generals, by the Secretary of State and by others.	[]	ABUSIVE POLITICAL LEADERS ARE PHYSICAL BULLIES
The issue was exposed to the light of day.	[]	ABILITY TO KNOW IS ABILITY TO SEE
His judgement is clouded.	[]	ABILITY TO EVALUATE IS ABILITY TO SEE
